################################################
#@       ##                         ##         #
#        ##  #####################  ##         #
#    ######  #             #                   #
# $      ##  #######  ###  # #####  ##         #
#        ##  #     #    #  #   #    ##         #
#####    ##  #  #  ###  #  ##  ###  ##         #
#        ##  #  #  #    #      #    ##         #
#        ##  #  #  #  ##########  ####         #
#   #######  #  #  #  #      #      ##         #
#        ##  #  #  #  #  ##  #  ##  ##         #
######   ##  #  #  #     #   #   #  ##         #
#        ##  ####  ####  #########  ##         #
#  ########           #      #   #  ##         #
#        #################   #   #  ##         #
#     #                      #      ##         #
################################################