################################################
#@       ##                         ##         #
#        ##  ###### ##############  ##         #
#    ######  #             #                   #
# $      ##  ### ###  ###  # #####  ##         #
#        ##  #     #    #  #   #    ##         #
#####    ##  #  #  ###  #  ##  ###  ##         #
#        ##  #  #  #    #      #    ##         #
#        ##  #  #  #  ##########  ####         #
#    ## ###  #  #  #  #      #      ##         #
#        ##     #  #  #  ##  #  ##  ##         #
# ####   ##  #  #  #     #   #   #  ##         #
#        ##  ####  ####  #########             #
#    ######           #      #   #  ##         #
#        ####  ###########   #   #  ##         #
#     #                      #      ##         #
################################################